 /--------------------\  /--------------------------------\  /--------------------\ 
 |  .  .  .  .  .  .  |  |  .  .  .  .  .  .  .  .  .  .  |  |  .  .  .  .  .  .  | 
 |  .  /--------\  .  |  |  .  /--------------------\  .  |  |  .  /--------\  .  | 
 |  *  | ###### |  .  |  |  .  | ################## |  .  |  |  .  | ###### |  *  | 
 |  .  \--------/  .  \--/  .  \--------------------/  .  \--/  .  \--------/  .  | 
 |  .  .  .  .  .  .  .  .  .  .  .  .  .  .  .  .  .  .  .  .  .  .  .  .  .  .  | 
 |  .  /--------\  .  /--\  .  /--------------------\  .  /--\  .  /--------\  .  | 
 |  .  \--------/  .  |  |  .  \--------\  /--------/  .  |  |  .  \--------/  .  | 
 |  .  .  .  .  .  .  |  |  .  .  .  .  |  |  .  .  .  .  |  |  .  .  .  .  .  .  | 
 \--------------\  .  |  \--------\  .  |  |  .  /--------/  |  .  /--------------/ 
############### |  .  |  /--------/  .  \--/  .  \--------\  |  .  | ###############
############### |  .  |  |                                |  |  .  | ###############
############### |  .  |  |     /-------      -------\     |  |  .  | ###############
----------------/  .  \--/     |                    |     \--/  .  \----------------
 A                 .           |                    |           .                 B 
----------------\  .  /--\     |                    |     /--\  .  /----------------
############### |  .  |  |     \--------------------/     |  |  .  | ###############
############### |  .  |  |                                |  |  .  | ###############
############### |  .  |  |     /--\  .  /--\  .  /--\     |  |  .  | ###############
 /--------------/  .  \--/     |  |  .  |  |  .  |  |     \--/  .  \--------------\ 
 |  .  .  .  .  .  .  .  .  .  |  |  .  |  |  .  |  |  .  .  .  .  .  .  .  .  .  | 
 |  .  /--------\  .  /--------/  |  .  |  |  .  |  \--------\  .  /--------\  .  | 
 |  *  \-----\  |  .  \-----------/  .  \--/  .  \-----------/  .  |  /-----/  *  | 
 |  .  .  .  |  |  .  .  .  .  .  .  .  .  .  .  .  .  .  .  .  .  |  |  .  .  .  | 
 \-----\  .  |  |  .  /-----------\  .  /--\  .  /-----------\  .  |  |  .  /-----/ 
 /-----/  .  \--/  .  |  /--------/  .  |  |  .  \--------\  |  .  \--/  .  \-----\ 
 |  .  .  .  .  .  .  |  |  .  .  .  .  |  |  .  .  .  .  |  |  .  .  .  .  .  .  | 
 |  .  /--------------/  |  .  /--------/  \--------\  .  |  \--------------\  .  | 
 |  .  \-----------------/  .  \--------------------/  .  \-----------------/  .  | 
 |  .  .  .  .  .  .  .  .  .  .  .  .  .  .  .  .  .  .  .  .  .  .  .  .  .  .  | 
 \--------------------------------------------------------------------------------/ 
